11111111111111111111111
1000000P000000000000001
10000010100000000000001
10011110111111111000001
1001C000100010001111001
10011110101010C000C1001
100000101010I0010111001
10000010C010C001C001001
10000011111111111101001
10000000000000000101001
100000000000000000E0001
11111111111111111111111