111111111111
1P00C0000001
10000000C001
100000E00001
10C000000001
100000000C01
100000000001
10C00000I0C1
111111111111