11111111
1P00C001
100000C1
10000001
10C0I0E1
11111111