1111111111
1P00C00001
10000000C1
10000000C1
1000000001
1000000001
10C0000IE1
1111111111