11111111111111111111111111
100000000P0000000000000001
10000C00000000000000000001
1000000000000C000000000001
10000000000000000000000001
10000000C0000000C000000001
10000000000000000000000001
10000000000000000000000001
1000000000000000I000000001
100000000000000000000000E1
11111111111111111111111111