11111111111111111111
100000000P0000000001
10000C0000000C000001
10000000000000000001
100000000000000000C1
10000000000000000001
1000000000000000I001
1C000000000C00000C01
10000000000000000001
10000C000000000000E1
11111111111111111111