11111111111
1P0C0000001
1000000C001
10000E00001
10000000C01
10C0000I0C1
11111111111