111111111111111111111111111111
10C0000000000P0000000000011111
111111000C00001111111110I11111
100000000000000000111110011111
100C00001111111110111110011111
10000000111111111C111110011111
1I0000000000001110100000011111
100000000000C0111010C011111111
100000000000000000000011111111
100000000111001111100011111111
100000000111001111100011111111
1I0000000111001111100011111111
10000000011100111110C011111111
1C00000001110C1111100011111111
1000000001110011111I00000000E1
111111111111111111111111111111