11111
22222
33333
44444
55555
EPCCC