111111111111111
1C00000000000P1
111111000C00001
100000000000001
100C00001111111
100000001111111
100000000000001
10000E000000001
1C00000000000C1
100000000000001
111111111111111