11111111
1P000001
100000C1
100E0001
11111111