11111111
10000001
1000P0C1
100E0001
11111111