111111111111111111111111
100000000P00000000000C01
10000C0000000C0000000001
100000000000000000000001
10C000000000000000000C01
100000000000000000000001
10000000000C000000000C01
1000000000000000000000C1
100000000000000000000001
100000000000000000000001
1C0000000000000000000001
10C00000000C000000000C01
100000000000000000000001
1000000000000000000000E1
111111111111111111111111