111111
1P00Z1
100001
1C00E1
111111