111111
1P0001
100001
1C00E1
011111