111111
1P00011
100001
1C0001
111111