111111
100001
1000E1
1C0001
111111