111111
1P1001
111001
1C00E1
111111